о-prep: "о чем-то (A1)" "about [a topic]" о@ @prepositional
в-час: "в час (частота)" "per [duration]" в@ tag:time@acc
в-num-час: "в ... часов (A2)" "at [time] o'clock" в@ tag:number час@
в-num-час: "в ... часов (A2)" "at [time]" в@ tag:number
2-gen: "два чего-то (A1)" "two [something]" два@ adjective@genitive* noun@genitive*
not-gen: "нет чего-то (A1)" "there is/are no [something]" нет[none]@ @genitive
not-gen: "нет чего-то (A1)" "there were no [something]" не@ быть@ @genitive
gen-of: "что-то чего-то" "of [something]" @genitive+
gen-possession: "что-то чьё-то" "of [someone]" tag:animate@genitive
teach: "научить кого-то чему-то" "teach [someone] [something]" научить|учить@ @accusative+ @dative+
рад-dat: "рад чему-то" " happy to see [someone]" рад@ @dat
чем-чем: "чем ... тем ..." "the ... the" что@instr any тот@instrn
если-то: "если ... то" "if ... then" если@ any то[если]@
how-old: "сколько лет кому-то ... ?" "how old is [someone]" сколько@ год@genpl @dative
с-gen: "с (откуда, с какого времени) (A1)" "from [somewhere, sometime, something]" с@ @genitive
с-чего-взял: "с чего кто-то взял" "where did tag:animate get the idea from" с@ что@gen tag:animate взять@
time-acc: "время (interval/repeating) TODO: only apply this one if nothing with prepositions applies(A1)" "for a [certain amount of time]" tag:time@acc
time-acc: "время (interval/repeating) TODO: only apply this one if nothing with prepositions applies(A1)" "for [number] tag:time" tag:number@accusative tag:time
много-gen: "много чего-то (A1)" "many/a lot of [something]" много@ @genitive
без-gen: "без чего-то (B1)" "without [something]" без@ @genitive+
at-instr: "утром / вечером / зимой ... (B2)" "in the [time of day/season]" tag:at-instr@instrumental
more-than: "больше / лучше / ... чем" "more @comp than [someone/something]" @comp any ,@ что@instr
три-gen: "три чего-то (A1)" "three [something]" три@ adjective@genitive* noun@genitive+
четыре-gen: "четыре чего-то (A1)" "four [something]" четыре@ adjective@genitive* noun@genitive*
мало-gen: "мало чего-то (A1)" "not much/many [something] " мало@ adjective@genitive* noun@genitive*
немного-gen: "немного чего-то (A1)" "some/a bit [something]" немного@ adjective@genitive* noun@genitive*
немного-gen: "немного чего-то (A1)" "some/a bit [something]" adjective@genitive* noun@genitive* немного@
с-instr: "(вместе) с (кем-то) (A1)" "together with [someone]" с@ adjective@* tag:animate@instrumental
при-prep: "при ком/чём" "is with [him/her]" при@ @prepositional+
по-dat: "по кому/чему TODO: split up" "on [something]" по@ @dat
сам-по-себе: "сам по себе" "by -self" сам@ по@ себя@dat
из-за-того: "из-за того" "because of" из-за@ тот@genn
поверить-dat: "поверить чему-то" "believe [someone]" поверить@ @dat
ни-any-кто: "ни ... кто" "no one" ни@ any кто@
ни-any-что: "ни ... что" "nothing" ни@ any что@
с-тех-пор: "с тех пор" "since the time" с@ тот@ пора@
мы-с-instr: "мы с кем-то" "I and [someone]" мы@ с@ @instr
no-matter-what: "во что бы то ни стало" "come what may" в@alt что@ бы@ тот@n ни@ стать@
в-пути: "в пути" "on the road" в@ путь@
на-пути: "на пути" "on the adjective@* road" на@ adjective@* путь@
всё-ещё: "всё@ ещё" "still" всё@ ещё@
столько-всего: "столько всего" "so much" столько@ всего@
нет-равных: "нет равных" "have no equal" нет[none]@ равный@genpl
ни-не: "ни чего-то не " "not any [something]" ни@ @gen не@
так-adv: "так много / …" "so much [something]" так@ @adv
по-карману: "по карману" "can afford" по@ карман@dat
не-так-ли: "не так ли" "is that not so?" не@ так@ ли@
бы-не-past: "no matter what" "no matter tag:question tag:animate" tag:question бы@ tag:animate не@
за-то-что: "за то, что" "for doing something" за@ тот@accn
в-курсе: "в курсе TODO: might need a second phrase with gen at the end" "to be aware" в@ курс@prep
verb-acc: "делать что-то / видить кого-то / ..." "verb [something]" verb@+ any @accusative+
verb-acc: "делать что-то / видить кого-то / ..." "[something] verb" @accusative+ any verb@+
с-чем: "с (чем-то) (A1)" "with [something or someone]" с@ adjective@instr* @instrumental
говорить-с: "говорить с кем" "talk to [someone]" говорить@ с@ @instr
встречать-с: "встречаться с" "meet (with) [someone]" встречаться@ any с@
обращаться-с: "обращаться с" "deal with [something] / treat [someone]" обращаться@ с@ @instr
обращаться-к: "обращаться к" "address / turn to [someone]" обращаться@ к@ @dative+
у-его-нет: "у кого-то нет чего-то (A1)" "[someone] does not have [something]" у@ @genitive нет[none]@ @genitive
у-кого: "у кого-то (есть) (A1)" "[someone] have" у@ tag:animate@genitive
из-gen-departure: "из пункта отправления (A1)" "from [point of departure/source]" из@ @genitive+
at-datpl: "по (утрам / вечерам ...) (B1)" "every [day of the week/time of day/season] " по@ tag:time@datpl
у-кого-location: "у кого-то (место) (A2)" "at [someone]'s location" у@ tag:animate@genitive
от-gen-departure: "откуда (A2)" "from where [something] is located" от@ @genitive
от-кого-source: "ключ от чего-то" "key to [something]" ключ@ от@ @genitive
часть-чего-то: "часть чего-то (A2)" "part of [something]" часть@ @genitive
до-point-of-destination: "до чего-то (A2)" "to [somewhere]" до@ @genitive
до-какого-то-времени: "до какого-то времени (A2)" "until [sometime]" до@ @genitive
после-чего-то: "после чего-то (A2)" "after [a time/doing something]" после@ @genitive
во-время-чего-то: "во время чего-то (A2)" "during [some activity]" в@ время@acc @genitive
около-чего-то: "около чего-то (B1)" "around [some location]" около@ adjective@genitive* numeral@genitive* @genitive
далеко-от-чего-то: "далеко от чего-то (B1)" "far away from [something]" далеко@ от@ adjective@genitive* @genitive
недалеко-от-чего-то: "недалеко от чего-то (B1)" "not far away from [something]" недалеко@ от@ adjective@genitive* @genitive
справа-от-чего-то: "справа от чего-то (B1)" "to the right of [something]" справа@ от@ @gen
слева-от-чего-то: "слева от чего-то (B1)" "to the left of [something]" слева@ от@ @gen
вокруг-чего-то: "вокруг чего-то (B1)" "around [something]" вокруг@ @gen
напротив-чего-то: "напротив чего-то (B1)" "across from [something]" напротив@ @gen
среди-чего-то: "среди чего-то (B1)" "amongst / in the middle of [something]" среди@ @genitive
для-чего-то: "для чего-то или кого-то (B1)" "for [something or someone]" для@ @gen
ни-за-что: "ни за что" "no way" ни@ за@ что@
к-кому-чему: "к (кому-то) (A1)" "to [person as destination]" к@ @dative+
ждать-for-something-abstract: "ждать for something abstract (B1)" "wait for [something abstract]" ждать@ @gen
хотеть-something-abstract: "хотеть something abstract (B1)" "want [something abstract]" хотеть@ @gen
comp-gen: "больше / лучше / ... with genitive (B1) " "comp [something]" @comp @genitive+
звать-кого-то: "звать кого-то" "call [someone]" звать@ @accusative+
звать-кого-то: "звать кого-то" "[someone] is called" @accusative+ звать@
на-направление: "на somewhere (направление) (A1)" "to [somewhere]" на@ @accusative
на-завтрак-обед-ужин: "на завтрак/обед/ужин" "for [meal]" на@ tag:meal@acc
в-направление: "в направление (A1)" "to [direction]" в@ @accusative
в-time: "в четверг (moment in time/day) (A1)" "at [moment in time]" в@ adjective@accusative* tag:time@accusative
каждый-time: "каждый/весь/целый... (time)" "adjective@accusative+ [time]" adjective@accusative+ tag:time@accusative
так-же: "так же, как" "like" такой@ же@ any
так-же: "так же, как" "like" @ как@
не-больше: "больше не" "no longer" больше[longer]@comp не@
для-того: "для того что" "adjective enough to" adjective@+ для@ тот@genn ,@ @* чтобы@
давно-пора: "давно пора" "it is high time" давно@ пора@
похожо: "похожо" "seems like" похожий@adv
тут-и-там: "тут и там" "here and there" там@ и@ тут@
друг-другу: "друг другу" "each other" друг@ any друг@
работать-над-чем-то: "работать над чем-то" "work on [something]" работать@ над@ @instrumental
hyperbole: "hyperbole" "@instrumental+ (exaggerating)" @instrumental+
доволен-instr: "доволен" "satisfied with [something]" довольный@ @instrumental+
ждать-что-то: "ждать for something (B1)" "wait for [something or someone]" ждать@ @acc
хотеть-что-то: "хотеть [something or someone] (B1)" "want [something or someone] (B1)" хотеть@ @accusative
похоже: "похоже" "seems like" похожий@adv
за-direction: "за (направление) (B1)" "behind/beyond [direction]" за@ @acc
через-direction: "через (направление) (B1)" "through, across [direction]" через@ @accusative
через-time: "через (время) (B1)" "after, in [time]" через@ any tag:time@acc
на-time: "на (время) (B1)" "for [time]" на@ tag:time@acc
за-time: "за (время) (B1)" "in [time]" за@ any tag:time@acc
person-experiencing-a-state: "кому-то хорошо/плохо... (A2)" "[dat] feel(s) adjective@adv+" tag:animate@dat adjective@adv+
по-place-of-movement: "по (дороге/улице...) (A2)" "along, through [somewhere]" по@ @dative+
по-mode-of-communication: "по (телефону/телевизору....) (A2)" "on [mode of communication]" по@ @dat
как-можно-comp: "как можно (скорее...)" "as comp as possible" как@ можно@ @comp
по-definition: "по (математике...) (A2)" "по [definition]" по@ @dat
кому-то-надо: "(кому-то) надо (B1)" "[someone] needs" @dative+ any надо@
кому-то-нужно: "(кому-то) нужно (A1)" "[someone] needs" @dative any нужно@
на-твоем-месте: "на твоём месте" "in [someone's] position" бы@ на@ adjective@prep* место@prep
кому-то-можно: "(кому-то) можно (B1)" "[someone] may" @dat+ можно@
кому-то-нельзя: "(кому-то) нельзя (B1)" "[someone] is not allowed" @dative нельзя@
по-очереди: "по очереди" "one by one" по@ очередь@dat
по-возможности: "по возможности" "if possible" по@ возможность@dat
заниматься-чем-то: "заниматься (чем-то) (A1)" "take part in [activity]" заниматься@ @instr
быть-кем-то: "быть (кем-то) (A1)" "be [someone]" быть@ @instr
стать-кем-то: "стать (кем-то) (A2)" "become [someone]" стать@ @instr
работать-кем-то: "работать (кем-то) (A2)" "work as [someone]" работать@ @instr
над-чем-то: "над (чем-то) (A2)" "over [something]" над@ @instrumental
под-чем-то: "под (чем-то) (A2)" "under [something]" под@ @instr
рядом-с: "рядом с (чем-то) (A2)" "next to [something]" рядом@ с@ @instr
между-чем-то: "между (чем-то) (B1)" "between [something]" между@ @instrumental
за-место: "за (чем-то - место) (B1)" "behind, after [something]" за@ @instr+
следить-за-кем-то: "следить (за кем-то) TODO make pattern include nouns and pronouns that follow the verb" "follow, look after [someone or something]" следить@ за@ any @instrumental
за-столом: "за столом" "at the [table/desk - location]" за@ adjective@instrumental* стол@instr
за-границей: "за границей" "abroad" за@ граница@instr
перед-location: "перед (где)" "in front of [something]" перед@ @instr
перед-time: "перед (когда) (B1)" "before [some moment in time]" перед@ @instr
за-goal: "за чем-то (цель) (B1)" "to get [something]" за@ @instr
за-time-of-action: "за (время проишествия) (B2)" "during [time of action]" за@ @instr
интересоваться-чем-то: "интересоваться (чем-то) (A2)" "to be interested in [something]" интересоваться@ @instr
в-place: "в (где-то) (A1)" "in, at [a place]" в@ adjective@prepositional* @prepositional+
на-place: "на (где-то)" "at, in [a place]" на@ @prepositional+
на-языке: "на языке (B1)" "in [language]" на@ tag:language@prep
на-транспорте: "на транспорте (A1) TODO: make метро, такси inflect" "by [means of transportation]" на@ tag:tansport@prep
aslongas: "as long as" "as long as" сколько@accinanpl any
no-matter-how: "no matter how" "no matter how much/long" сколько@accinanpl any ни@ any
nazad: "назад" "[time] ago" @accusative+ назад@
во-сколько: "во сколько? (A2)" "at what time" в@ сколько@
при-condition: "при (каком-то условии) (B1)" "while [something]" при@ @prepositional+
someone-had: "у кого-то был (A1)" "[someone] had" у@ tag:animate@genitive быть@pastn
did-not-have: "у кого-то не было (A1)" "[someone] didn't have" у@ tag:animate@genitive не@ быть@past
деньги-на: "деньги на (что-то)" "money for [something]" деньги@ на@ adjective@accusative* @accusative
will-have: "у кого-то будет (A1)" "[someone] will have" у@ tag:animate@genitive быть[fut]@
will-not-have: "у кого-то не будет (A1)" "[someone] won't have" у@ tag:animate@genitive не@ быть[fut]@
как-зовут: "как зовут" "how are/is [person] called" как@ tag:animate@acc звать@
как-зовут: "как зовут" "how is [person] called" как@ звать@ any tag:animate@accusative
play-with: "играть на чём-то" "play (on) [instrument, device]" играть@ на@ @prepositional
за-окном: "за окном TODO: add instrpl?" "outside the window" за@ окно@instr
за-стол: "за стол (куда)" "at the table [where to]" за@ стол@acc
сколько-время: "сколько [время]" "how long" сколько@
сколько-distance: "сколько [расстояние]" "how far" сколько@
go-do: "идти verb" "go [verb] " идти@ verb@+
к-чему-то: "к чему-то (B1)" "to [place, not person]" к@ @dative+
к-time: "к какому-то времени (?B1)" "by [moment in time]" к@ @dative+
думать-над: "думать над чем-то" "think [somthing] over" думать|подумать@ над@
сколько-amount: "сколько [количество]" "how much" сколько@
Вот-это: "Вот это" "This is" вот@ это@
можно-noun: "можно noun" "can I have a noun@+" можно@ noun@+
пора–не: "пока не" "until" пока@ any не@
уверен-в: "уверен в" "certain of" уверенный@ в@ @prepositional+
так-что: "так что" "that is why" так@ что[that]@
так-как: "так как" "in the way that" так@ ,@ как@
время-от-времени: "время-от-времени" "from time to time" время@ от@ время@gen